####################
# ##################
# ##################
# ##################
# ##################
# ##################
#S##################
# ##################
# ##################
# ########         #
# ################ #
# ################ #
# ################ #
# ################ #
# ################ #
# ################ #
# ################ #
# ################ #
#          G       #
####################